{
    "1": "兵",
    "2": "将",
    "3": "兽",
    "4": "魔",
    "5": "妖",
    "6": "大妖",
    "7": "皇",
    "8": "帝",
    "9": "神"
}